################ ###############
#                              #
# # ## ######### ######## ## # #
# # ## ##              ## ## # #
# # ## ## ############### ## # #
# # ## ##              ## ## # #
# # ## ############### ## ## # #
# # ## ##              ## ## # #
# # ## ## ############ ## ## # #
# # ## ##              ## ## # #
# # ## ######### ######## ## # #
# # ## ######### ######## ## # #
# # ## ####     W      ## ## # #
# # ## ####           #   ## # #
# # ##    #           # #### # #
    ##### #           # ####    
# #    ## #           # ##   # #
# ## # ## #           # ## ### #
# ## # ## #           # ## ### #
# ## # ## ############# ## ### #
# ## # ## ############# ## ### #
# ## # ## #@          # ## ### #
# ## # ## ########### # ## ### #
# ## # ## #           # ## ### #
# ## # ## # ########### ## ### #
# ## # ## #           # ## ### #
# ## # ## ########### # ## ### #
# ## # ## #           # ## ### #
# ## # ## ###### ###### ## ### #
#                              #‍
################ ###############